	 ___      _______  __   __  _______  ___     
	|   |    |       ||  | |  ||       ||   |    
	|   |    |    ___||  |_|  ||    ___||   |    
	|   |    |   |___ |       ||   |___ |   |    
	|   |___ |    ___||       ||    ___||   |___ 
	|       ||   |___  |     | |   |___ |       |
	|_______||_______|  |___|  |_______||_______|
